26 26 26 26 26 26 26 26 26 26 26 26 26 26 26 26 14 10 10 10 10 10 10 10 10 10 11 6 6 6 6 6 6 6 26 26 26 26 26 26 26 26 25 25 26 26 26 26 26 26 
26 26 26 26 26 26 26 25 25 25 26 26 26 26 26 26 14 10 10 10 10 10 10 10 10 10 11 6 6 6 6 6 6 6 26 26 26 26 26 25 25 25 25 25 25 25 26 26 26 26 
26 26 26 26 26 25 25 25 26 26 26 26 26 26 26 26 14 10 10 10 10 10 10 10 10 10 11 6 6 6 6 6 6 6 6 26 26 26 25 25 26 26 26 26 26 25 26 26 26 26 
26 26 26 26 25 25 26 26 26 26 26 26 26 26 26 26 14 10 10 10 10 10 10 10 10 10 11 6 6 6 6 6 6 6 6 26 26 25 25 26 26 26 26 26 26 26 26 26 26 26 
26 26 26 26 25 26 26 26 26 26 26 26 26 26 26 26 14 10 10 10 10 10 10 10 10 10 21 2 6 6 6 6 6 6 6 26 26 25 25 26 26 26 26 26 26 26 26 26 26 26 
26 26 26 26 25 25 26 26 26 26 26 26 26 26 26 26 14 10 10 10 10 10 10 10 10 10 10 21 2 6 6 6 6 6 6 26 26 26 25 25 25 26 26 26 26 26 26 26 26 26 
26 26 26 26 26 25 25 26 26 26 26 26 26 26 26 26 14 10 10 10 10 10 10 10 10 10 10 10 11 6 6 6 6 6 26 26 26 26 26 26 25 25 25 25 26 26 26 26 26 26 
26 26 26 26 26 26 25 25 26 26 26 26 26 26 26 26 14 10 10 10 10 10 10 10 10 10 10 10 21 2 6 6 6 6 26 26 26 26 26 26 26 26 26 25 26 26 26 26 26 26 
26 26 26 26 26 26 25 25 26 26 26 26 26 26 26 26 14 10 10 10 10 10 10 10 10 10 10 10 10 11 6 6 6 6 6 26 26 26 26 26 26 26 26 25 26 26 26 26 26 26 
26 26 26 26 26 26 26 26 26 26 26 26 26 26 26 26 14 10 10 10 3 4 5 10 10 10 10 10 10 10 2 6 6 6 26 26 26 26 26 26 26 26 26 26 26 26 26 26 26 26 
26 26 26 26 26 26 26 26 26 26 26 26 26 26 26 26 14 10 10 10 11 6 18 5 10 10 10 10 10 10 10 21 2 6 6 26 26 26 26 26 26 26 26 26 26 26 26 26 26 26 
26 26 26 26 26 26 26 26 26 26 26 26 26 26 26 26 14 10 10 10 11 6 6 18 5 10 10 10 10 10 10 10 21 2 26 26 26 26 26 26 26 26 26 26 26 26 26 26 26 26 
26 26 26 26 26 26 26 26 26 25 25 26 26 26 26 26 14 10 10 10 11 6 6 6 14 10 10 10 10 10 10 10 10 11 26 26 26 26 26 26 26 26 26 26 26 26 26 26 26 26 
26 26 26 26 26 26 26 25 25 25 26 26 26 26 26 26 14 10 10 10 11 6 6 6 14 10 10 10 10 10 10 10 10 11 26 26 26 26 26 26 26 26 26 26 25 25 25 25 26 26 
26 26 26 26 26 26 25 25 26 26 26 26 26 26 26 26 14 10 10 10 11 6 6 6 14 10 10 10 10 10 10 10 10 11 26 26 26 26 26 26 26 26 25 25 25 26 26 26 26 26 
26 26 26 26 26 25 25 26 26 26 26 26 26 26 26 26 14 10 10 10 11 6 6 6 14 10 10 10 10 10 10 10 10 11 26 26 26 26 26 26 25 25 26 26 26 26 26 26 26 26 
26 26 26 26 26 25 26 26 26 26 26 26 26 26 26 26 14 10 10 10 11 6 6 6 14 10 10 10 10 10 10 10 10 11 26 26 26 26 26 26 25 26 26 26 26 26 26 26 26 26 
26 26 26 26 26 25 25 26 26 22 26 26 26 26 26 26 14 10 10 10 11 6 6 6 18 5 10 10 10 10 10 10 10 11 26 26 26 26 26 26 25 26 26 26 26 26 26 26 26 26 
26 26 26 26 26 26 25 25 9 10 11 26 26 26 26 26 14 10 10 10 11 26 26 6 6 18 5 10 10 10 10 10 10 11 26 26 26 26 26 26 25 26 26 26 26 26 26 26 26 26 
26 26 26 26 26 26 26 25 9 10 11 26 26 26 26 26 14 10 10 10 11 26 26 26 6 6 18 5 10 10 10 10 10 11 26 26 26 26 26 26 25 25 26 26 26 26 26 26 26 26 
26 26 26 26 26 26 26 26 9 10 11 26 26 26 26 26 14 10 10 10 11 26 26 26 26 26 6 18 5 10 10 10 10 11 26 26 26 26 26 26 26 26 25 25 25 26 26 26 26 26 
26 26 26 26 26 26 26 26 9 10 11 26 26 26 26 26 14 10 10 10 11 26 26 26 26 26 6 6 6 18 5 10 10 11 26 26 26 26 26 26 26 26 26 26 26 26 26 26 26 26 
26 26 26 26 26 26 26 9 10 10 11 26 26 26 26 26 14 10 10 10 11 26 26 26 26 26 26 26 26 6 18 5 10 11 26 26 26 26 26 26 26 26 26 26 26 26 26 26 26 26 
26 26 26 26 26 26 26 9 10 4 26 26 26 26 26 26 14 10 10 10 11 26 26 26 26 26 26 26 26 26 6 9 10 11 26 26 26 25 25 26 26 26 26 26 26 26 26 26 26 26 
26 26 26 26 26 26 9 10 10 26 26 26 26 26 26 26 14 10 10 10 11 26 26 26 26 26 26 26 26 6 0 23 10 11 26 26 26 26 25 26 26 26 25 25 25 25 25 25 25 26 
26 26 26 26 26 9 10 10 4 26 26 26 26 26 26 26 14 10 10 10 11 26 26 26 26 26 6 6 6 0 23 10 10 11 26 26 25 25 25 26 26 25 25 26 26 26 26 25 25 26 
26 26 26 26 26 9 10 10 26 26 26 26 26 26 26 26 14 10 10 10 11 26 26 26 26 6 6 0 23 10 10 10 10 11 26 26 25 26 26 26 26 25 26 26 26 26 26 26 25 26 
26 26 26 26 26 9 10 10 26 26 26 26 26 26 26 25 14 10 10 10 11 26 26 26 26 6 0 23 10 10 10 10 10 12 26 26 25 25 26 26 26 26 26 26 26 26 26 26 25 26 
26 26 26 26 26 9 10 10 11 26 26 26 26 26 26 26 14 10 10 10 11 26 26 26 26 6 18 5 10 10 10 10 10 12 26 26 26 25 25 26 26 26 26 26 25 26 25 25 25 26 
26 26 26 26 26 9 10 10 11 26 26 26 26 26 26 26 14 10 10 10 11 26 7 26 26 7 6 9 10 10 10 10 10 12 26 26 26 26 25 25 26 26 26 26 25 25 25 26 26 26 
26 26 26 26 26 26 9 10 10 11 26 26 26 26 26 26 14 10 10 10 11 26 7 26 7 7 6 9 10 10 10 10 10 12 26 26 26 26 26 25 26 26 26 26 26 26 26 26 26 26 
26 26 26 26 26 26 26 9 10 10 11 26 26 26 26 26 14 10 10 10 11 26 7 26 7 7 6 9 10 10 10 10 10 12 26 26 26 26 26 26 25 26 26 26 26 26 26 26 26 26 
26 26 26 26 26 26 26 9 10 10 10 11 26 26 26 26 14 10 10 10 11 7 7 7 7 7 6 9 10 10 10 10 10 12 26 26 26 26 25 25 26 26 26 26 26 26 26 26 26 26 
26 26 26 26 26 26 26 26 9 10 10 10 11 26 26 26 14 10 10 10 11 7 7 7 7 6 6 9 10 10 10 10 10 12 26 26 26 25 25 26 26 26 26 26 25 25 26 26 26 26 
26 26 26 26 26 26 26 26 26 9 10 10 10 11 26 26 14 10 10 10 11 6 6 6 6 6 6 18 5 10 10 10 10 12 26 26 25 25 26 26 26 26 26 25 25 26 26 26 26 26 
26 26 26 26 26 26 26 26 26 26 26 4 10 11 26 26 14 10 10 10 11 6 6 6 6 6 6 6 18 5 10 10 10 12 26 26 25 26 26 26 26 26 25 25 26 26 26 26 26 26 
26 26 26 26 26 26 26 26 26 26 26 26 10 10 11 26 14 10 10 10 11 6 6 6 6 6 6 6 6 18 5 10 10 11 26 26 25 25 26 26 26 26 25 25 26 26 26 26 26 26 
26 26 26 26 26 25 25 25 25 26 26 26 9 10 11 26 14 10 10 10 11 6 6 6 6 6 6 6 6 6 9 10 10 11 26 26 26 25 25 26 26 26 26 25 25 26 26 26 26 26 
26 26 26 26 25 25 26 26 26 26 26 26 9 10 11 26 14 10 10 10 11 6 6 6 6 6 6 6 6 6 9 10 10 11 26 26 26 26 25 25 26 26 26 26 26 26 26 26 26 26 
26 26 26 25 25 26 26 26 26 26 26 9 10 10 11 25 14 10 10 10 11 6 6 6 6 6 6 6 6 6 9 10 10 11 26 26 26 26 26 25 25 26 26 26 26 26 26 26 26 26 
26 26 26 26 25 25 25 25 25 25 9 10 10 10 11 26 14 10 10 10 11 6 6 6 6 6 6 6 6 6 9 10 10 11 26 26 26 26 26 26 25 26 26 26 26 26 26 26 26 26 
26 26 26 26 26 26 26 26 26 25 9 10 4 4 26 26 14 10 10 10 11 6 6 6 6 6 6 6 6 6 9 10 10 11 26 26 26 26 26 25 25 26 26 25 25 25 25 26 26 26 
26 26 26 26 26 26 26 25 25 9 10 10 26 25 26 26 14 10 10 10 11 6 6 6 6 6 6 6 6 9 10 10 10 11 26 26 26 26 25 25 26 26 25 25 26 26 25 25 26 26 
26 26 26 26 26 26 25 25 26 9 10 4 26 26 26 26 14 10 10 10 11 6 6 6 6 6 6 6 6 6 9 10 10 11 26 26 26 25 25 25 25 25 25 25 25 25 26 25 26 26 
26 26 26 26 26 25 25 25 9 10 10 26 26 26 26 26 14 10 10 10 11 6 6 6 6 6 6 6 6 6 9 10 10 11 26 26 25 25 26 25 25 25 25 26 26 26 26 25 26 26 
26 26 26 26 25 25 26 26 26 4 4 26 26 26 26 26 14 10 10 10 11 6 6 6 6 6 6 6 6 6 9 10 10 11 26 26 25 25 25 25 26 25 26 26 26 26 26 25 26 26 
26 26 26 26 25 26 26 26 26 26 26 26 25 25 25 26 14 10 10 10 11 6 6 6 6 6 6 6 6 9 10 10 10 11 26 26 25 25 26 26 26 25 25 25 25 25 25 25 26 26 
26 26 26 26 25 25 26 26 26 26 26 26 26 26 25 26 14 10 10 10 11 6 6 6 6 6 6 9 10 10 10 10 10 11 26 26 25 25 26 26 26 25 25 26 26 26 26 25 25 26 
26 26 26 25 25 25 25 26 26 26 26 26 26 26 25 26 14 10 10 10 11 6 6 6 6 6 6 9 10 10 10 10 10 11 26 26 26 25 25 25 26 26 25 25 25 26 26 25 25 26 
26 26 26 26 26 26 26 26 26 26 26 26 26 26 26 26 14 10 10 10 11 6 6 6 6 6 6 9 10 10 10 10 10 11 26 26 26 26 26 25 26 26 26 25 25 25 25 26 26 26 
