4 4 4 4 4 4 4 4 5 4 4 4 4 4 4 4
4 1 1 1 1 1 1 1 5 1 1 1 1 1 1 4
4 1 1 1 1 1 1 1 5 1 1 1 1 1 1 4
4 1 1 1 1 1 1 5 5 1 1 1 1 1 1 4
4 1 1 1 1 1 1 5 1 1 1 1 1 1 1 4
4 1 1 1 1 1 1 5 1 1 1 1 1 1 1 4
4 1 1 1 1 1 5 5 1 1 1 1 1 1 1 4
4 1 1 1 1 1 5 1 1 1 1 1 1 1 1 4
4 1 1 1 1 1 5 1 1 1 1 1 1 1 1 4
4 1 1 1 1 5 5 1 1 1 1 1 1 1 1 4
4 1 1 1 1 5 1 1 1 1 1 1 1 1 1 4
4 4 4 4 5 5 4 4 4 4 4 4 4 4 4 4