0 1 1 1 1 1 1 1 1 1 1 1 1 1 1 1 1 2 13 13 0 1 1 1 1 1 1 1 1 1 2 13 13 0 1 1 1 1 1 1 1 1 1 1 1 1 1 1 1 2 
9 10 10 10 10 10 10 10 10 10 10 10 10 10 10 10 10 11 13 13 9 10 10 10 10 10 10 10 10 10 11 13 13 9 10 10 10 10 10 10 10 10 10 10 10 10 10 10 10 11 
9 10 10 10 10 10 10 10 10 10 10 10 10 10 10 10 10 11 13 13 9 10 10 10 10 10 10 10 10 10 11 13 13 9 10 10 10 10 10 10 10 10 10 10 10 10 10 10 10 11 
9 10 10 10 10 10 10 10 10 10 10 10 10 10 10 10 10 11 13 13 9 10 10 10 10 10 10 10 10 10 11 13 13 9 10 10 10 10 10 10 10 10 10 10 10 10 10 10 10 11 
9 10 10 10 10 10 10 10 10 10 10 10 10 10 10 10 10 11 13 13 9 10 10 10 10 10 10 10 10 10 11 13 13 9 10 10 10 10 10 10 10 10 10 10 10 10 10 10 10 11 
9 10 10 10 10 10 10 10 10 10 10 10 10 10 10 10 10 11 13 13 9 10 10 10 10 10 10 10 10 10 11 13 13 9 10 10 10 10 10 10 10 10 10 10 10 10 10 10 10 11 
9 10 10 10 10 10 10 10 10 10 10 10 10 10 10 10 10 11 13 13 9 10 10 10 10 10 10 10 10 10 11 13 13 9 10 10 10 10 10 10 10 10 10 10 10 10 10 10 10 11 
9 10 10 10 10 10 10 10 10 10 10 10 10 10 10 10 10 11 13 13 9 10 10 10 10 10 10 10 10 10 11 13 13 9 10 10 10 10 10 10 10 10 10 10 10 10 10 10 10 11 
18 4 4 4 4 4 4 4 4 4 4 4 4 4 4 4 4 20 13 13 9 10 10 10 10 10 10 10 10 10 11 13 13 18 19 19 19 19 19 19 19 19 19 19 19 19 19 19 19 20 
13 13 13 13 13 13 13 13 13 13 13 13 13 13 13 13 13 13 13 13 18 5 10 10 10 10 10 10 10 3 20 13 13 13 13 13 13 13 13 13 13 13 13 13 13 13 13 13 13 13 
13 13 13 13 13 13 13 13 13 13 13 13 13 13 13 13 13 13 13 13 13 18 5 10 10 10 10 10 3 20 13 13 13 13 13 13 13 13 13 13 13 13 13 13 13 13 13 13 13 13 
0 22 22 22 22 22 22 22 22 22 22 22 22 22 22 22 22 22 2 13 13 13 18 5 10 10 10 3 20 13 13 13 0 22 22 22 22 22 22 22 22 22 22 22 22 22 22 22 22 2 
9 10 10 10 10 10 10 10 10 10 10 10 10 10 10 10 10 10 21 2 13 13 13 18 5 10 3 20 13 13 13 0 23 10 10 10 10 10 10 10 10 10 10 10 10 10 10 10 10 11 
9 10 10 10 10 10 10 10 10 10 10 10 10 10 10 10 10 10 10 21 2 13 13 13 18 4 20 13 13 13 0 23 10 10 10 10 10 10 10 10 10 10 10 10 10 10 10 10 10 11 
9 10 10 10 10 10 10 10 10 10 10 10 10 10 10 10 10 10 10 10 21 2 13 13 13 13 13 13 13 0 23 10 10 10 10 10 10 10 10 10 10 10 10 10 10 10 10 10 10 11 
9 10 10 10 10 10 10 10 10 10 10 10 10 10 10 10 10 10 10 10 10 21 2 13 13 13 13 13 0 23 10 10 10 10 10 10 10 10 10 10 10 10 10 10 10 10 10 10 10 11 
9 10 10 10 10 10 10 10 10 10 10 10 10 10 10 10 10 10 10 10 10 10 21 2 13 13 13 0 23 10 10 10 10 10 10 10 10 10 10 10 10 10 10 10 10 10 10 10 10 11 
9 10 10 10 10 10 10 10 10 10 10 10 10 10 3 4 4 4 4 4 4 4 4 4 13 13 13 18 4 4 4 4 4 4 4 4 5 10 10 10 10 10 10 10 10 10 10 10 10 11 
9 10 10 10 10 10 10 10 10 10 10 10 10 10 11 13 13 13 13 13 13 13 13 13 13 13 13 13 13 13 13 13 13 13 13 13 9 10 10 10 10 10 10 10 10 10 10 10 10 11 
9 10 10 10 10 10 10 10 10 10 10 10 10 10 11 13 13 13 13 13 13 13 13 13 13 13 13 13 13 13 13 13 13 13 13 13 9 10 10 10 10 10 10 10 10 10 10 10 10 11 
9 10 10 10 10 10 10 10 10 10 10 10 10 10 11 13 13 0 1 22 22 22 22 22 22 22 1 1 1 1 1 1 1 2 13 13 9 10 10 10 10 10 10 10 10 10 10 10 10 11 
9 10 10 10 10 10 10 10 10 10 10 10 10 10 11 13 13 9 10 10 10 10 10 10 10 10 10 10 10 10 10 10 10 11 13 13 9 10 10 10 10 10 10 10 10 10 10 10 10 11 
9 10 10 10 10 10 10 10 10 10 10 10 10 10 11 13 13 9 10 10 10 10 10 10 10 10 10 10 10 10 10 10 10 11 13 13 9 10 10 10 10 10 10 10 10 10 10 10 10 11 
9 10 10 10 10 10 10 10 10 10 10 10 10 10 11 13 13 9 10 10 10 10 10 10 10 10 10 10 10 10 10 10 10 11 13 13 9 10 10 10 10 10 10 10 10 10 10 10 10 11 
9 10 10 10 10 10 10 10 10 10 10 10 10 10 11 13 13 9 10 10 10 10 10 10 10 10 10 10 10 10 10 10 10 11 13 13 9 10 10 10 10 10 10 10 10 10 10 10 10 11 
9 10 10 10 10 10 10 10 10 10 10 10 10 10 11 13 13 9 10 10 10 10 10 10 10 10 10 10 10 10 10 10 10 11 13 13 9 10 10 10 10 10 10 10 10 10 10 10 10 11 
9 10 10 10 10 10 10 10 10 10 10 10 10 10 11 13 13 9 10 10 10 10 10 10 10 10 10 10 10 10 10 10 10 11 13 13 9 10 10 10 10 10 10 10 10 10 10 10 10 11 
9 10 10 10 10 10 10 10 10 10 10 10 10 10 11 13 13 9 10 10 10 10 10 10 10 10 10 10 10 10 10 10 10 11 13 13 9 10 10 10 10 10 10 10 10 10 10 10 10 11 
9 10 10 10 10 10 10 10 10 10 10 10 10 10 11 13 13 9 10 10 10 10 10 10 10 10 10 10 10 10 10 10 10 11 13 13 9 10 10 10 10 10 10 10 10 10 10 10 10 11 
18 19 19 19 19 19 19 19 19 19 19 19 19 19 20 13 13 9 10 10 10 10 10 10 10 10 10 10 10 10 10 10 10 11 13 13 18 19 19 19 19 19 19 19 19 19 19 19 19 20 
13 13 13 13 13 13 13 13 13 13 13 13 13 13 13 13 13 18 4 4 4 4 4 4 4 4 4 4 4 4 4 4 4 20 13 13 13 13 13 13 13 13 13 13 13 13 13 13 13 13 
13 13 13 13 13 13 13 13 13 13 13 13 13 13 13 13 13 13 13 13 13 13 13 13 13 13 13 13 13 13 13 13 13 13 13 13 13 13 13 13 13 13 13 13 13 13 13 13 13 13 
0 22 22 22 22 22 22 22 22 22 22 22 22 22 2 13 13 13 13 13 13 13 13 13 13 13 13 13 13 13 13 13 13 13 13 13 0 22 22 22 22 22 22 22 22 22 22 22 22 2 
9 10 10 10 10 10 10 10 10 10 10 10 10 10 11 13 13 0 22 22 22 22 22 22 22 22 22 22 22 22 22 22 22 2 13 13 9 10 10 10 10 10 10 10 10 10 10 10 10 11 
9 10 10 10 10 10 10 10 10 10 10 10 10 10 11 13 13 9 10 10 10 10 10 10 10 10 10 10 10 10 10 10 10 11 13 13 9 10 10 10 10 10 10 10 10 10 10 10 10 11 
9 10 10 10 10 10 10 10 10 10 10 10 10 10 11 13 13 9 10 10 10 10 10 10 10 10 10 10 10 10 10 10 10 11 13 13 9 10 10 10 10 10 10 10 10 10 10 10 10 11 
9 10 10 10 10 10 10 10 10 10 10 10 10 10 11 13 13 9 10 10 10 10 10 10 10 10 10 10 10 10 10 10 10 11 13 13 9 10 10 10 10 10 10 10 10 10 10 10 10 11 
9 10 10 10 10 10 10 10 10 10 10 10 10 10 11 13 13 9 10 10 10 10 10 10 10 10 10 10 10 10 10 10 10 11 13 13 9 10 10 10 10 10 10 10 10 10 10 10 10 11 
9 10 10 10 10 10 10 10 10 10 10 10 10 10 11 13 13 9 10 10 10 10 10 10 10 10 10 10 10 10 10 10 10 11 13 13 9 10 10 10 10 10 10 10 10 10 10 10 10 11 
9 10 10 10 10 10 10 10 10 10 10 10 10 10 11 13 13 9 10 10 10 10 10 10 10 10 10 10 10 10 10 10 10 11 13 13 9 10 10 10 10 10 10 10 10 10 10 10 10 11 
9 10 10 10 10 10 10 10 10 10 10 10 10 10 11 13 13 9 10 10 10 10 10 10 10 10 10 10 10 10 10 10 10 11 13 13 9 10 10 10 10 10 10 10 10 10 10 10 10 11 
9 10 10 10 10 10 10 10 10 10 10 10 10 10 11 13 13 9 10 10 10 10 10 10 10 10 10 10 10 10 10 10 10 11 13 13 9 10 10 10 10 10 10 10 10 10 10 10 10 11 
9 10 10 10 10 10 10 10 10 10 10 10 10 10 11 13 13 9 10 10 10 10 10 10 10 10 10 10 10 10 10 10 10 11 13 13 9 10 10 10 10 10 10 10 10 10 10 10 10 11 
9 10 10 10 10 10 10 10 10 10 10 10 10 10 11 13 13 9 10 10 10 10 10 10 10 10 10 10 10 10 10 10 10 11 13 13 9 10 10 10 10 10 10 10 10 10 10 10 10 11 
9 10 10 10 10 10 10 10 10 10 10 10 10 10 11 13 13 9 10 10 10 10 10 10 10 10 10 10 10 10 10 10 10 11 13 13 9 10 10 10 10 10 10 10 10 10 10 10 10 11 
9 10 10 10 10 10 10 10 10 10 10 10 10 10 11 13 13 9 10 10 10 10 10 10 10 10 10 10 10 10 10 10 10 11 13 13 9 10 10 10 10 10 10 10 10 10 10 10 10 11 
9 10 10 10 10 10 10 10 10 10 10 10 10 10 11 13 13 9 10 10 10 10 10 10 10 10 10 10 10 10 10 10 10 11 13 13 9 10 10 10 10 10 10 10 10 10 10 10 10 11 
9 10 10 10 10 10 10 10 10 10 10 10 10 10 11 13 13 9 10 10 10 10 10 10 10 10 10 10 10 10 10 10 10 11 13 13 9 10 10 10 10 10 10 10 10 10 10 10 10 11 
9 10 10 10 10 10 10 10 10 10 10 10 10 10 11 13 13 9 10 10 10 10 10 10 10 10 10 10 10 10 10 10 10 11 13 13 9 10 10 10 10 10 10 10 10 10 10 10 10 11 
18 4 4 4 4 4 4 4 4 4 4 4 4 4 20 13 13 18 4 4 4 4 4 4 4 4 4 4 4 4 4 4 4 20 13 13 18 4 4 4 4 4 4 4 4 4 4 4 4 20 
