10 10 10 10 10 10 10 8 13 6 10 10 10 10 10 10 10 10 10 10 10 10 10 8 13 6 10 10 10 10 10 10 10 10 10 10 10 10 10 8 13 6 10 10 10 10 10 10 10 10
13 13 13 13 13 13 13 13 13 13 13 13 13 13 13 13 13 13 13 13 13 13 13 13 13 13 13 13 13 13 13 13 13 13 13 13 13 13 13 13 13 13 13 13 13 13 13 13 13 13
16 16 16 16 16 16 16 2 13 0 16 16 16 16 16 16 16 16 16 16 16 16 16 2 13 0 16 16 16 16 16 16 16 16 16 16 16 16 16 2 13 0 16 16 16 16 16 16 16 16
4 4 4 4 4 4 4 12 13 14 4 4 4 4 4 4 4 4 4 4 4 4 4 12 13 14 4 4 4 4 4 4 4 4 4 4 4 4 4 12 13 14 4 4 4 4 4 4 4 4
4 4 4 4 4 4 4 12 13 14 4 4 4 4 4 4 4 4 4 4 4 4 4 12 13 14 4 4 4 4 4 4 4 4 4 4 4 4 4 12 13 14 4 4 4 4 4 4 4 4
4 4 4 4 4 4 4 12 13 14 4 4 4 4 4 4 4 4 4 4 4 4 4 12 13 14 4 4 4 4 4 4 4 4 4 4 4 4 4 12 13 14 4 4 4 4 4 4 4 4
4 4 4 4 4 4 4 12 13 14 4 4 4 4 4 4 4 4 4 4 4 4 4 12 13 14 4 4 4 4 4 4 4 4 4 4 4 4 4 12 13 14 4 4 4 4 4 4 4 4
4 4 4 4 4 4 4 12 13 14 4 4 4 4 4 4 4 4 4 4 4 4 4 12 13 14 4 4 4 4 4 4 4 4 4 4 4 4 4 12 13 14 4 4 4 4 4 4 4 4
4 4 4 4 4 4 4 12 13 14 4 4 4 4 4 4 4 4 4 4 4 4 4 12 13 14 4 4 4 4 4 4 4 4 4 4 4 4 4 12 13 14 4 4 4 4 4 4 4 4
4 4 4 4 4 4 4 12 13 14 4 4 4 4 4 4 4 4 4 4 4 4 4 12 13 14 4 4 4 4 4 4 4 4 4 4 4 4 4 12 13 14 4 4 4 4 4 4 4 4
4 4 4 4 4 4 4 12 13 14 4 4 4 4 4 4 4 4 4 4 4 4 4 12 13 14 4 4 4 4 4 4 4 4 4 4 4 4 4 12 13 14 4 4 4 4 4 4 4 4
4 4 4 4 4 4 4 12 13 14 4 4 4 4 4 4 4 4 4 4 4 4 4 12 13 14 4 4 4 4 4 4 4 4 4 4 4 4 4 12 13 14 4 4 4 4 4 4 4 4
10 10 10 10 10 10 10 8 13 6 10 10 10 10 10 10 10 10 10 10 10 10 10 8 13 6 10 10 10 10 10 10 10 10 10 10 10 10 10 8 13 6 10 10 10 10 10 10 10 10
13 13 13 13 13 13 13 13 13 13 13 13 13 13 13 13 13 13 13 13 13 13 13 13 13 13 13 13 13 13 13 13 13 13 13 13 13 13 13 13 13 13 13 13 13 13 13 13 13 13
16 16 16 16 16 16 16 2 13 0 16 16 16 16 16 16 16 16 16 16 16 16 16 2 13 0 16 16 16 16 16 16 16 16 16 16 16 16 16 2 13 0 16 16 16 16 16 16 16 16
4 4 4 4 4 4 4 12 13 14 4 4 4 4 4 4 4 4 4 4 4 4 4 12 13 14 4 4 4 4 4 4 4 4 4 4 4 4 4 12 13 14 4 4 4 4 4 4 4 4
4 4 4 4 4 4 4 12 13 14 4 4 4 4 4 4 4 4 4 4 4 4 4 12 13 14 4 4 4 4 4 4 4 4 4 4 4 4 4 12 13 14 4 4 4 4 4 4 4 4
4 4 4 4 4 4 4 12 13 14 4 4 4 4 4 4 4 4 4 4 4 4 4 12 13 14 4 4 4 4 4 4 4 4 4 4 4 4 4 12 13 14 4 4 4 4 4 4 4 4
4 4 4 4 4 4 4 12 13 14 4 4 4 4 4 4 4 4 4 4 4 4 4 12 13 14 4 4 4 4 4 4 4 4 4 4 4 4 4 12 13 14 4 4 4 4 4 4 4 4
4 4 4 4 4 4 4 12 13 14 4 4 4 4 4 4 4 4 4 4 4 4 4 12 13 14 4 4 4 4 4 4 4 4 4 4 4 4 4 12 13 14 4 4 4 4 4 4 4 4
4 4 4 4 4 4 4 12 13 14 4 4 4 4 4 4 4 4 4 4 4 4 4 12 13 14 4 4 4 4 4 4 4 4 4 4 4 4 4 12 13 14 4 4 4 4 4 4 4 4
4 4 4 4 4 4 4 12 13 14 4 4 4 4 4 4 4 4 4 4 4 4 4 12 13 14 4 4 4 4 4 4 4 4 4 4 4 4 4 12 13 14 4 4 4 4 4 4 4 4
4 4 4 4 4 4 4 12 13 14 4 4 4 4 4 4 4 4 4 4 4 4 4 12 13 14 4 4 4 4 4 4 4 4 4 4 4 4 4 12 13 14 4 4 4 4 4 4 4 4
4 4 4 4 4 4 4 12 13 14 4 4 4 4 4 4 4 4 4 4 4 4 4 12 13 14 4 4 4 4 4 4 4 4 4 4 4 4 4 12 13 14 4 4 4 4 4 4 4 4
10 10 10 10 10 10 10 8 13 6 10 10 10 10 10 10 10 10 10 10 10 10 10 8 13 6 10 10 10 10 10 10 10 10 10 10 10 10 10 8 13 6 10 10 10 10 10 10 10 10
13 13 13 13 13 13 13 13 13 13 13 13 13 13 13 13 13 13 13 13 13 13 13 13 13 13 13 13 13 13 13 13 13 13 13 13 13 13 13 13 13 13 13 13 13 13 13 13 13 13
16 16 16 16 16 16 16 2 13 0 16 16 16 16 16 16 16 16 16 16 16 16 16 2 13 0 16 16 16 16 16 16 16 16 16 16 16 16 16 2 13 0 16 16 16 16 16 16 16 16
4 4 4 4 4 4 4 12 13 14 4 4 4 4 4 4 4 4 4 4 4 4 4 12 13 14 4 4 4 4 4 4 4 4 4 4 4 4 4 12 13 14 4 4 4 4 4 4 4 4
4 4 4 4 4 4 4 12 13 14 4 4 4 4 4 4 4 4 4 4 4 4 4 12 13 14 4 4 4 4 4 4 4 4 4 4 4 4 4 12 13 14 4 4 4 4 4 4 4 4
4 4 4 4 4 4 4 12 13 14 4 4 4 4 4 4 4 4 4 4 4 4 4 12 13 14 4 4 4 4 4 4 4 4 4 4 4 4 4 12 13 14 4 4 4 4 4 4 4 4
4 4 4 4 4 4 4 12 13 14 4 4 4 4 4 4 4 4 4 4 4 4 4 12 13 14 4 4 4 4 4 4 4 4 4 4 4 4 4 12 13 14 4 4 4 4 4 4 4 4
4 4 4 4 4 4 4 12 13 14 4 4 4 4 4 4 4 4 4 4 4 4 4 12 13 14 4 4 4 4 4 4 4 4 4 4 4 4 4 12 13 14 4 4 4 4 4 4 4 4
4 4 4 4 4 4 4 12 13 14 4 4 4 4 4 4 4 4 4 4 4 4 4 12 13 14 4 4 4 4 4 4 4 4 4 4 4 4 4 12 13 14 4 4 4 4 4 4 4 4
4 4 4 4 4 4 4 12 13 14 4 4 4 4 4 4 4 4 4 4 4 4 4 12 13 14 4 4 4 4 4 4 4 4 4 4 4 4 4 12 13 14 4 4 4 4 4 4 4 4
4 4 4 4 4 4 4 12 13 14 4 4 4 4 4 4 4 4 4 4 4 4 4 12 13 14 4 4 4 4 4 4 4 4 4 4 4 4 4 12 13 14 4 4 4 4 4 4 4 4
4 4 4 4 4 4 4 12 13 14 4 4 4 4 4 4 4 4 4 4 4 4 4 12 13 14 4 4 4 4 4 4 4 4 4 4 4 4 4 12 13 14 4 4 4 4 4 4 4 4
10 10 10 10 10 10 10 8 13 6 10 10 10 10 10 10 10 10 10 10 10 10 10 8 13 6 10 10 10 10 10 10 10 10 10 10 10 10 10 8 13 6 10 10 10 10 10 10 10 10
13 13 13 13 13 13 13 13 13 13 13 13 13 13 13 13 13 13 13 13 13 13 13 13 13 13 13 13 13 13 13 13 13 13 13 13 13 13 13 13 13 13 13 13 13 13 13 13 13 13
16 16 16 16 16 16 16 2 13 0 16 16 16 16 16 16 16 16 16 16 16 16 16 2 13 0 16 16 16 16 16 16 16 16 16 16 16 16 16 2 13 0 16 16 16 16 16 16 16 16
4 4 4 4 4 4 4 12 13 14 4 4 4 4 4 4 4 4 4 4 4 4 4 12 13 14 4 4 4 4 4 4 4 4 4 4 4 4 4 12 13 14 4 4 4 4 4 4 4 4
4 4 4 4 4 4 4 12 13 14 4 4 4 4 4 4 4 4 4 4 4 4 4 12 13 14 4 4 4 4 4 4 4 4 4 4 4 4 4 12 13 14 4 4 4 4 4 4 4 4
4 4 4 4 4 4 4 12 13 14 4 4 4 4 4 4 4 4 4 4 4 4 4 12 13 14 4 4 4 4 4 4 4 4 4 4 4 4 4 12 13 14 4 4 4 4 4 4 4 4
4 4 4 4 4 4 4 12 13 14 4 4 4 4 4 4 4 4 4 4 4 4 4 12 13 14 4 4 4 4 4 4 4 4 4 4 4 4 4 12 13 14 4 4 4 4 4 4 4 4
4 4 4 4 4 4 4 12 13 14 4 4 4 4 4 4 4 4 4 4 4 4 4 12 13 14 4 4 4 4 4 4 4 4 4 4 4 4 4 12 13 14 4 4 4 4 4 4 4 4
4 4 4 4 4 4 4 12 13 14 4 4 4 4 4 4 4 4 4 4 4 4 4 12 13 14 4 4 4 4 4 4 4 4 4 4 4 4 4 12 13 14 4 4 4 4 4 4 4 4
10 10 10 10 10 10 10 8 13 6 10 10 10 10 10 10 10 10 10 10 10 10 10 8 13 6 10 10 10 10 10 10 10 10 10 10 10 10 10 8 13 6 10 10 10 10 10 10 10 10